76,76,76,76,76,76,76,76,76,76,76,76,76,76,76,76,76,76,76,76,76,76,76,76,76,
76,1,1,1,1,1,1,1,1,1,1,1,1,1,1,1,1,1,1,1,1,1,1,1,76,
76,1,1,1,1,1,1,1,1,1,1,1,1,1,1,1,1,1,1,1,1,1,1,1,76,
76,1,1,1,1,28,28,1,1,1,1,1,1,1,1,1,1,1,1,1,1,1,1,1,76,
76,1,1,1,1,28,28,1,1,1,1,1,1,1,1,1,1,1,1,1,1,1,1,1,76,
76,1,1,1,1,28,28,1,1,1,1,1,1,1,1,1,1,1,1,1,1,1,1,1,76,
76,1,1,1,1,1,1,1,1,1,1,1,1,1,1,1,1,1,1,1,1,1,1,1,76,
76,1,1,1,1,1,1,1,1,1,1,1,1,1,1,1,1,1,1,1,1,1,1,1,76,
76,1,1,1,76,76,76,76,1,1,1,1,1,1,1,1,1,1,1,1,1,1,1,1,76,
76,1,1,1,1,1,1,76,1,1,1,1,1,1,1,1,1,1,1,1,1,1,1,1,76,
76,1,1,1,1,1,1,76,1,1,1,1,1,1,1,1,1,1,1,1,1,1,1,1,76,
76,1,1,1,1,1,1,1,1,1,1,1,1,1,76,1,1,1,1,1,1,1,1,1,76,
76,1,1,1,1,1,1,1,1,1,1,1,1,1,76,1,76,1,1,1,1,1,1,1,76,
76,1,1,1,1,1,1,1,1,1,1,1,1,1,76,76,76,1,1,1,1,1,1,1,76,
76,1,1,1,1,1,1,1,1,1,1,1,1,1,1,1,1,1,1,1,1,1,1,1,76,
76,76,76,76,76,76,76,76,76,76,76,76,76,76,76,76,76,76,76,76,76,76,76,76,76,